1111111111
1P000001C1
1111011101
1C000000E1
1011111101
1C00000001
1111111111
